6 7
1 4 4 2 5 0
1 4 4 0 4 0
1 0 4 0 4 6
1 2 7 1 0 4
3 1 4 2 3 1
1 0 4 0 4 6